########################################
#@.....................................#
#H.....................................#
#......................................#
#...#.........#########................#
#...#.........#........................#
#...#.........#........................#
#.............#####....................#
#......................................#
#......................................#
#......................................#
#.....................................Z#
########################################