########################################
#@.............Z.......................#
#......................................#
#......................................#
#.............#########................#
#.............#...#....................#
#.............#...#....................#
#.............#####....................#
#......................................#
#......................................#
#......................................#
#......................................#
########################################