########################################
#@.....................................#
#......................................#
#......................................#
#...#.........#########................#
#...#.........#...#....................#
#...#.........#...#....................#
#.............#####....................#
#......................................#
#......................................#
#......................................#
#.....................................Z#
########################################