##################################################################
#@...............................................................#
#................................................................#
#................................................................#
#................................................................#
#................................................................#
#................................................................#
#................................................................#
#................................................................#
#................................................................#
#...............................#................................#
#................................................................#
#................................................................#
#................................................................#
#................................................................#
#................................................................#
#................................................................#
#................................................................#
#................................................................#
#................................................................#
#................................................................#
#................................................................#
#................................................................#
#................................................................#
##################################################################