########################################
#@.............Z.......................#
#......................................#
#......................................#
#...#.........#########................#
#...#.........#...#....................#
#...#.........#...#....................#
#.............#####....................#
#......................................#
#......................................#
#......................................#
#......................................#
########################################